SO ./textures/wood.xpm42

F 40,117,14



NO ./textures/eagle.xpm42
WE ./textures/purplestone.xpm42
EA                 ./textures/mossy.xpm42




C 28,226,         252

11111    11111
10001    10001
10001    1000111
10001111 1000001
1000000111000111
10000000000001
10000000011001
10011100011111
1001 100011111
10011100000001
10N00000011111
1000000001
10000000011111
10111000000001
101 1000000001
101 1000000001
111 1111111111