SO ./textures/bluestone.xpm42

F 40,117,14



NO ./textures/42logo.xpm42
WE ./textures/colorstone.xpm42
EA                 ./textures/redbrick.xpm42




C 28,226,252



                   11111111111                         
                  1100000000001                          
                 110000000000001
                11000000000000001
               1100000000000000001111
               1000000000000000000001
 111111111111111000000000000000000000111111111111111111
 100000000000000000000000000000000000000000000000000001
 100000000000000000000000000000000000000000000011111111
 100000000000000000000000000000000000000000000011111111
 100000000000000000000000000000000000000000000000000001
 100000000000000000000101010101010000000000000000000001
 100000000000000000000000000000000000000000000000000001
 100000000E00000000000101010101010000000011111111111111
 100000000000000000000000000000000000000010000000000001
 100000000000000000000101010101010000000010000000000001
 100000000000000000000000000000000000000010000011000001
 100000000000000000000101010101010000000000000011000001
 100000000000000000000000000000000000000010000000000001
 111000111110000000000000000000000000000010000000000001
 100000000010000000000000000000000000000011111111111111
 100000000010000000000000000000000000000000000000000001
 100000000010000010101010101010101010100000000000000001
 111111111111111111111111111111111111111111111111111111