SO ./textures/bluestone.xpm42

F 40,117,14



NO ./textures/42logo.xpm42
WE ./textures/colorstone.xpm42
EA                 ./textures/redbrick.xpm42




C 28,226,252




    1111
11111001
10000001
10111111
10W01
10011
11111