1111111111111111111111111111
10000000000001000000000000C1
10P0000C000001000E0000000001
1111111111000100111000111111
1000000C000001000000000X0001
10000000000001XX0XX1100XX001
100000000X0001000XXX10001101
1000000000000100000000000001
1000111111111111111110100001
100000000X00000000C100100001
1000010000000100XXX10X1000C1
1000010000000100000000100001
1000010CC000010000XXXX000001
1111111111111111111111111111