1111111111111111111111111111
1000000000000100000XXX000001
10P0000C000001000E0000000001
1111111111000100111000111101
1000000C00000100000000000001
1000000000000100000010000001
1000000X00000100000010001101
100000000000010000XXX0000001
1000111111111111111100100001
100000000000000000C10010X001
10X001000XX0010000010010X0C1
1000000CC0000100XX0000000001
1111111111111111111111111111