11111111111111111111111111111111111111111111
10000000000001000000000000000000000000000001
1000000C000001000000000000000000000000000E01
100000000000010000C0000000000000000000000001
1000000C000001000000000000000000000000000001
10000000000001000000000000000000000000000001
10000000000000000000000000000000000000000001
10000000000000000000000000000000000000000001
10000000000000000000000000000000000000000001
10000000000000000000000000000000000000000001
10000000000000000000000000000000000000000001
10000000000000000000000000000000000000000001
10000000000000000000000000000000000000000001
10000000000000000000000000000000000000000001
10000000000000000000000000000000000000000001
10000000000000000000000000000000000000000001
10000000000000000000000000000000000000000001
10000000000000000000001000000000000000000001
100000000000000000C0001000000000000000000001
1000P0000000000000000010000000000000000000C1
10000000000001000000001000000000000000000001
11111111111111111111111111111111111111111111