11111111111111111111111111111
10000000000001000000000000001
1000000C0000010000X0000000E01
100000000000010000C0000000001
1000000C000001000000000X00001
10000000000001000000000000001
100000000X000X000X0X000000001
1000000000X0000X00X0000000001
1000000000X0XX000X00001000001
100000000X00000000C0001000001
1000P0000000000000000010000C1
10000000000001000000001000001
11111111111111111111111111111
