11111111111
1E000000001
10000000001
1P0000000C1
11111111111