1111111111111111111111111111
10C00000000100010C1000000001
1000000000010001001001000001
100001000100000C000001000001
1P00010C0100C0C00100C10C01E1
10000000010000X0010001X00001
1111111111111111111111111111