11111111111111111111111111
10000000000000000000000001
10P0000C00000000000CCC0001
10000000011111111111000001
1000000C000X0000000000X001
10000000010000000000000C01
1000000001000C000000000001
100000000100000X0000111101
1000000001000000X000100001
10000000000000000000100001
1000000CC0000000X0000000E1
11111111111111111111111111