1111111111111111111111111111
1000000000000100000000000001
10P0000C000001000E0000000001
1111111111000100111000111101
1000000C00000100000000000001
1000000000000100000010000001
1000000000000100000010001101
1000000000000100000000000001
1000111111111111111100100001
100000000000000000C100100001
10000100000001000001001000C1
1000000CC0000100000000000001
1111111111111111111111111111