11111111111111111111111111111
10000000000001000000000000001
10P0000C000001000E00000000001
11111111110001001110001111101
1000000C000001000000000000001
10000000000001000001100000001
10000000000001000000100011001
10000000000001000000000000001
10001111111111111111101000001
100000000000000000C1001000001
100001000000010000010010000C1
10000100000001000000001000001
1000010CC0000100000XXXXX00001
11111111111111111111111111111