11111111111111
10000000000001
100PCE00000C01
11111111111111